#domain
hospital
#levelname
AIMASqln
#colors
blue: 0,1,2,3,A,B,C,D,E,F
#initial
++++++++++++++++++++++++++++++++++++++++++++
+  0+           +         +             3  +
+ ++++++++++ ++++++++++++++++++++++++ ++++ +
+ +    +    +                          +   +
+ ++++ + ++ + ++++ +++++++++++++++ +++++   +
+ +    +           +                +      +
+ ++++++++++ ++++++++++++++++++++++++ +++  +
+  1            +         +              2 +
++++++++++++++++++++++++++++++++++++++++++ +
+   +         +                            +
+ + + ++++++ + + +++ +++++++++++ +++ +++++ +
+ + +  A A A+ +   +  B B B B B +   +  C C C+
+ + ++++ + + +++++  + ++++  +++++  + +++++ +
+ +     +   +      +   +   +      +   +    +
+ +++++++++   +++++ + + + + +++++ + +++++  +
+           +        D  + E +       F    + +
++++++++++++++++++++++++++++++++++++++++++++
#goal
++++++++++++++++++++++++++++++++++++++++++++
+ E0+           +         +             3  +
+ ++++++++++ ++++++++++++++++++++++++ ++++ +
+ +    + B  +                          +   +
+ ++++ + ++ + ++++ +++++++++++++++ +++++   +
+ +    +           +F               +      +
+ ++++++++++ ++++++++++++++++++++++++ +++  +
+  1            +         +  B           2 +
++++++++++++++++++++++++++++++++++++++++++ +
+   +         +  C                         +
+ + + ++++++ + + +++ +++++++++++ +++ +++++ +
+ + +       + +   +            +   +       +
+ + ++++ + + +++++  + ++++  +++++  + +++++ +
+ +    D+   +      +   +   +      +   +    +
+ +++++++++   +++++ + + + + +++++ + +++++  +
+C          +           +   +            +A+
++++++++++++++++++++++++++++++++++++++++++++
#end