#domain
hospital
#levelname
BOSSMAn
#colors
blue: 0, A, 9
red: 1, B
cyan: 2, C
purple: 3, D
green: 4, E
orange: 5, F
pink: 6, G
grey: 7, H
lightblue: 8, I
#initial
++++++++++++++++++++++++++++++
+                            +
+                            +
+                        9   +
+B+C+D+E+F+G+H+I+A+          +
+0+1+2+3+4+5+6+7+8+          +
++++++++++++++++++++++       +
+        I                   +
+ ++++++++++++++++++++++++++++
+         A        +++++     +
++++++++++++++++         +   +
+              +++++++++++   +
+A    A      A     A         +
+                            +
++++++++++++++++++++++++++++++
#goal
++++++++++++++++++++++++++++++
+A B C D E F G H I           +
+                            +
+                            +
+ + + + + + + + + +          +
+0+1+2+3+4+5+6+7+8+          +
++++++++++++++++++++++       +
+                            +
+ ++++++++++++++++++++++++++++
+                  +++++     +
++++++++++++++++         +   +
+              +++++++++++   +
+                            +
+A    A     A      A         +
++++++++++++++++++++++++++++++
#end
