#domain
hospital
#levelname
cbsSolve
#colors
blue: 0, A
red: 1, B
cyan: 2, C
purple: 3, D
green: 4, E
orange: 5, F
pink: 6, G
grey: 7, H
lightblue: 8, I
#initial
+++++++++++++++++++++++++++
+0  1     3  4  5        8+
+  +++      +E  ++        +
+   +  +  + +   +   + 7+  +
+  +B  + +  +   F+G + + + +
+   +    +     ++ +   H   +
+      +    + +  +     ++ +
+     C++     + 6      +  +
++  +  +     +++ +        +
+2        +     +    +   I+
+A  +   D +    +  +   ++  +
+       +     ++     +    +
+   +++++  +   +     +  +++
++   +    +    ++        ++
+                         +
+++++++++++++++++++++++++++
#goal
+++++++++++++++++++++++++++
+0  1     3  4  5        8+
+  +++      +   ++        +
+   +  +  + +   +   + 7+  +
+  +   + +  +    +  + + + +
+   +    +     ++ +       +
+      +    + +  +     ++ +
+      ++     + 6      +  +
++  +  +     +++ +        +
+2        +     +    +    +
+   +     +    +  +   ++  +
+       +     ++     +    +
+   +++++  +   +     +  +++
++   +    +    ++        ++
+A  B  C  D  E  F  G  H  I+
+++++++++++++++++++++++++++
#end