#domain
hospital
#levelname
LoopLads
#colors
orange: 1, C, E, L
blue: 2, R, O, M
green: 0, D
#initial
+++++++++++++++++++
+       + +       +
+ CELL1 + + ROOM2 +
+       + +       +
++++D++++ ++++ ++++
+              D  +   
+                 +
+  D              + 
++++ ++++ ++++D++++
+       + +       +
+       + +       +
+       + +       +
+++++++++D+++++++++
+++++    0    +++++
+                 +
+++++         +++++
+                 +
+++++++++++++++++++
#goal
+++++++++++++++++++
+       + +       +
+       + +       +
+       + +       +
++++ ++++ ++++ ++++
+                 +
+                 +
+                 +
++++ ++++ ++++ ++++
+       + +       +
+       + +       +
+       + +       +
+++++++++ +++++++++
+++++         +++++
+CELL1            +
+++++         +++++
+0           2ROOM+
+++++++++++++++++++
#end
