#domain
hospital
#levelname
MAcustom1
#colors
red: 0, A, B
green: 1,C, D
blue: 2, E
#initial
++++++++++++++++++++++++++++++
+++++++++++  ++++ E 2+++++0 A+
++++++1   C         ++++++   +
+++++++++++++++        +++   +
+         +++++              +
+             +              +
+          ++++++++++++++    +
+          ++++++++++++++    +
+          ++++++++++++B     +
++++++++++++++++++++++++++++++
#goal
++++++++++++++++++++++++++++++
+++++++++++  ++++E   +++++   +
++++++      C       ++++++   +
+++++++++++++++        +++  A+
+         +++++              +
+             +              +
+          ++++++++++++++    +
+          ++++++++++++++    +
+          ++++++++++++     B+
++++++++++++++++++++++++++++++
#end
