#domain
hospital
#levelname
MAcustom2
#colors
red: 0, A, B
green: 1,C, D
blue: 2,3, E,F,G
#initial
++++++++++++++++++++++++++++++
+++++++++++  ++++ E 2+++++0 A+
++++++1   C         ++++++   +
+++++++++++++++      F +++   +
+         +++++      G       +
+             + 3            +
+          ++++++++++++++    +
+          ++++++++++++++    +
+          ++++++++++++B     +
++++++++++++++++++++++++++++++
#goal
++++++++++++++++++++++++++++++
+++++++++++  ++++E   +++++   +
++++++      C       ++++++   +
+++++++++++++++        +++  A+
+         +++++       F      +
+             +              +
+          ++++++++++++++    +
+          ++++++++++++++    +
+          ++++++++++++G    B+
++++++++++++++++++++++++++++++
#end