#domain
hospital
#levelname
MAcustom2
#colors
red: 0, A, B
green: 1,C, D
blue: 2,3,4,E,F,G,H,I,J,K
#initial
++++++++++++++++++++++++++++++
+++++++++++K ++++ E 2+++++0 A+
++++++1   C         ++++++   +
+++++++++++++++      F +++   +
++++      +++++      G       +
+  +          + 3            +
++++       ++++++++++++++    +
+4         ++++++++++++++    +
+    +++   ++++++++++++B     +
+    +H   I+                 +
+    +++++++                 +
+              ++++++++     ++
+++++          +J     +    +++
+   +  +       +         +++++    
+++++    +++++++++++++++++++++
++++++++++++++++++++++++++++++
#goal
++++++++++++++++++++++++++++++
+++++++++++  ++++   D+++++  C+
++++++              ++++++   +
+++++++++++++++       I+++   +
++++      +++++              +
+  +         F+E             +
++++       ++++++++++++++   J+
+  G       ++++++++++++++    +
+    +++   ++++++++++++B     +
+    +     +                 +
+    +++++++                 +
+              ++++++++    K++
+++++          +     B+    +++
+   + H+       +         +++++    
+++++A   +++++++++++++++++++++
++++++++++++++++++++++++++++++
#end