#domain
hospital
#levelname
MAPF00
#colors
blue: 0, A, C, E
green: 1, B, D, F
#initial
+++++++++++++
+0    C     +
+1    B  ++++
+     F     +
+ D   A  ++ +
+ E       + +
+++++++++++++
#goal
+++++++++++++
+ C     B 1 +
+ D      ++++
+ E         +
+ F      ++A+
+         +0+
+++++++++++++
#end
