#domain
hospital
#levelname
MAPF00
#colors
blue: 0
green: 1
red: 2
cyan: 3
orange: 4
#initial
+++++++++++++
+1 4       2+
+++++ +++++++
+           +
+        ++ +
+ 0      3+ +
+++++++++++++
#goal
+++++++++++++
+           +
+++++ +++++++
+    3 0    +
+    2 1 ++ +
+         +4+
+++++++++++++
#end
