#domain
hospital
#levelname
MAPF00
#colors
green: 0
red: 1
#initial
+++++++++++++
+0       1  +
+++++ +++++++
+           +
+        ++ +
+         + +
+++++++++++++
#goal
+++++++++++++
+           +
+++++ +++++++
+           +
+        ++ +
+   0 1   + +
+++++++++++++
#end
