#domain
hospital
#levelname
MAPF00
#colors
blue: 0
red: 1
cyan: 2
purple: 3
green: 4
orange: 5
pink: 6
grey: 7
lightblue: 8
brown: 9
#initial
++++++++++++++++++++++++++++++++++++++++
+0 1   4 3 2+                          +
+++++ +++++++ +++++++++++++++++++++++ ++
+           + +                     + ++
+        ++ + +9+ + + + + + ++++++ ++ ++
+         + + +8+ + + + + +    +++ ++ ++
+         + + +7+ + + + + + ++   + ++ ++
+         + + + +++++++++++ ++6 5+ ++ ++
+         +++ +++++++++++++ +++++++++ ++
+             +                       ++
++++++++++++++++++++++++++++++++++++++++
#goal
++++++++++++++++++++++++++++++++++++++++
+5 6   9 8 7+                          +
+++++ +++++++ +++++++++++++++++++++++ ++
+           + +                     + ++
+        ++ + +2+ + + + + + ++++++ ++ ++
+         + + +4+ + + + + +    +++ ++ ++
+         + + +0+ +3+ + + + ++   + ++ ++
+         + + +1+++++++++++ ++   + ++ ++
+         +++ +++++++++++++ +++++++++ ++
+             +                       ++
++++++++++++++++++++++++++++++++++++++++
#end
