#domain
hospital
#levelname
MAShrooms
#colors
red: 0, A, B
green: 1,C, D
blue: 2,3,E,F,G,H
#initial
++++++++++++++++++++++++++++++
+++++++++++  ++++ E 2+++++0 A+
++++++1   C         ++++++   +
+++++++++++++++      F +++   +
++++      +++++      G       +
+  +          + 3            +
++++       ++++++++++++++    +
+D         ++++++++++++++    +
+    +++   ++++++++++++B     +
+    +H    +                 +
+    +++++++                 +
+              ++++++++     ++
+++++          +      +    +++
+   +  +       +         +++++    
+++++    +++++++++++++++++++++
++++++++++++++++++++++++++++++
#goal
++++++++++++++++++++++++++++++
+++++++++++  ++++   D+++++  C+
++++++              ++++++   +
+++++++++++++++        +++   +
++++      +++++              +
+  +         F+E             +
++++       ++++++++++++++    +
+  G       ++++++++++++++    +
+    +++   ++++++++++++B     +
+    +     +                 +
+    +++++++                 +
+              ++++++++     ++
+++++          +      +    +++
+   + H+       +         +++++    
+++++A   +++++++++++++++++++++
++++++++++++++++++++++++++++++
#end