#domain
hospital
#levelname
MAShrooms
#colors
red: 0, A, B
green: 1,C, D
blue: 2,E,F
#initial
++++++++++++++++++++++++++++++
+++++++++++  ++++ E  +++++0 A+
++++++1   C         ++++++   +
+++++++++++++++      F +++   +
++++      +++++2             +
+  +          +              +
++++       ++++++++++++++    +
+D         ++++++++++++++    +
+    +++   ++++++++++++B     +
+    +     +                 +
+    +++++++                 +
+              ++++++++     ++
+++++          +      +    +++
+   +  +       +         +++++    
+++++    +++++++++++++++++++++
++++++++++++++++++++++++++++++
#goal
++++++++++++++++++++++++++++++
+++++++++++  ++++   D+++++  C+
++++++              ++++++   +
+++++++++++++++        +++   +
++++      +++++              +
+  +         F+E             +
++++       ++++++++++++++    +
+          ++++++++++++++    +
+    +++   ++++++++++++      +
+    +     +                 +
+    +++++++                 +
+              ++++++++     ++
+++++          +     B+    +++
+   +  +       +         +++++    
+++++A   +++++++++++++++++++++
++++++++++++++++++++++++++++++
#end