#domain
hospital
#levelname
MAsimple1
#colors
red: 0, A
green: 1, B
#initial
++++++++++++++++++++++++++++
+  B          0        A   +
+     1                    +
+ +++++++++++++++++        +
+                          +
++++++++++++++++++++++++++++
#goal
++++++++++++++++++++++++++++
+                       A  +
+B                         +
+ +++++++++++++++++        +
+                          +
++++++++++++++++++++++++++++
#end
