#domain
hospital
#levelname
SAMultiGoal
#colors
red: 0, A
blue: 1, B, C
#initial
+++++++++++++
+0          +
++    +++++++
+           +
+       C++ +
+         + +
+         + +
+         + +
+         + +
+         + +
+         +B+
+         + +
+A         1+
+++++++++++++
#goal
+++++++++++++
+           +
++    +++++++
+0     B    +
+        ++ +
+         + +
+         + +
+         + +
+        C+ +
+         + +
+        A+ +
+         + +
+           +
+++++++++++++
#end