#domain
hospital
#levelname
SAtest
#colors
blue: 0, A
#initial
++++++++++++++++++++++++
+                      +
+0       A             +
+                      +
+                      +
+        +++           +
+       ++   +++++++++++
++++++++++++++
#goal
++++++++++++++++++++++++
+                      +
+                      +
+                      +
+                      +
+        +++          A+
+       ++   +++++++++++
++++++++++++++
#end
