#domain
hospital
#levelname
testing
#colors
blue: 0, A, B, C
#initial
+++++++++++++++++++
+0                +
+              ++++
+                 +
+              ++ +
+              A+ +
+++++++++++++++++++
#goal
+++++++++++++++++++
+                 +
+              ++++
+                 +
+              ++ +
+               +A+
+++++++++++++++++++
#end
