#domain
hospital
#levelname
AgentWayz
#colors
red: 0, A, B
cyan: 1, C, D
blue: 2, E, F 
green: 3, G, H
#initial
+++++++++++++++++++
+0A      +      1C+
+        +        +
+        +        +
+        +        +
+        +        +
+        +        +
+        +        +
+                 +
+        +        +
+++++ +++++++ +++++
+        +        +
+ B      +      D +
+                 +
+        +        +
+3G      +        +
+                 +
+2E      +        +
+        +        +
+++++++++++++++++++
#goal
+++++++++++++++++++
+        +        +
+        +        +
+        +        +
+        +        +
+        +        +
+        +        +
+        +        +
+                 +
+C       +       A+
+++++ +++++++ +++++
+        +        +
+D       +       B+
+                 +
+        +        +
+        +       E+
+                 +
+        +       G+
+        +        +
+++++++++++++++++++
#end
