#domain
hospital
#levelname
AIronMANN
#colors
blue: 3,6,7
brown: 8,N,D
red: 1,I
grey: 9,M,O
orange: 0,2,A
cyan: 4,5,R
#initial
+++++++++++++++++++++
+0             A2   +
+  A      +         +
+    1I   +  N R  4 +
+         +   5     +
+ +++++++++++++++++ +
+         +N        +
+         + M  3    +
+   7    8+ O    N  +
+ 6       +9        +
+++++++++++++++++++++
#goal
+++++++++++++++++++++
+      1            +
+         +5        +
+         +4        +
+  2      +  3      +
+ +++++++++++++++++ +
+   6     +         +
+         +         +
+       79+         +
+   08 AI + RONMANN +
+++++++++++++++++++++
#end