#domain
hospital
#levelname
CINNAMON
#colors
blue: 0, A
red: 1, 4, B
cyan: 2, 5, C
green: 3, D
#initial
+++++++++++++++++++++++++
+ 2                   3 +
+ ++++++++++ ++++++++++ +
+ ++++++++++         B+ +
+ +++ 4+++++ ++++ +++ + +
+ ++5  B++++ ++++ + + + +
+ +++C +++++ ++++ + + + +
+ ++++++++++ ++++ +++ + +
+ ++++++++++ ++++A    + +
+ ++++++++++ ++++++++++ +
+                       +
+ ++++++++++ ++++++++++ +
+ +    D     ++++++++++ +
+ + +++ ++++ ++++++++++ +
+ + + + ++++ ++++++++++ +
+ + + + ++++ ++++++++++ +
+ + +++ ++++ ++++++++++ +
+ +C    ++++ ++++++++++ +
+ ++++++++++ ++++++++++ +
+ 1                   0 +
+++++++++++++++++++++++++
#goal
+++++++++++++++++++++++++
+C                     D+
+ ++++++++++ ++++++++++ +
+ ++++++++++          + +
+ +++C +++++ ++++ +++ + +
+ ++    ++++ ++++ + + + +
+ +++ B+++++ ++++ + + + +
+ ++++++++++ ++++ +++ + +
+ ++++++++++ ++++     + +
+ ++++++++++ ++++++++++ +
+                       +
+ ++++++++++ ++++++++++ +
+ +          ++++++++++ +
+ + +++ ++++ ++++++++++ +
+ + + + ++++ ++++++++++ +
+ + + + ++++ ++++++++++ +
+ + +++ ++++ ++++++++++ +
+ +     ++++ ++++++++++ +
+ ++++++++++ ++++++++++ +
+A                     B+
+++++++++++++++++++++++++
#end
