#domain
hospital
#levelname
GiveSnack
#colors
blue: 0, A, P
red: 1, B, I
cyan: 2, C, J
purple: 3, D, K
green: 4, E, L
orange: 5, F, M
pink: 6, G, N
grey: 7, H, O
lightblue: 8
#initial
+++++++++++++++++++++++++
+                       +
+  +  +++++++++++++++++ +
+  M  +0 P+1  +2  +   + +
+ 5K  +  A+   +   +   + +
+  B  +8  +   +   + 3 + +
+  J  +++ +++ +++ +++D+ +
+  O                    +
+                       +
+  I  + +++ +++ +++ +++ +
+  C  +   +   +  G+   + +
+  E  +  L+   +N  +   + +
+7 H  +  4+  F+6  +   + +
+  +  +++++++++++++++++ +
+                       +
+++++++++++++++++++++++++
#goal
+++++++++++++++++++++++++
+                       +
+  +  +++++++++++++++++ +
+     +  P+B I+C  +DK + +
+     +  A+   +J  +   + +
+     +   +   +   +   + +
+     +++ +++ +++ +++ + +
+                       +
+                       +
+     + +++ +++ +++ +++ +
+     +  E+  M+   + H + +
+     +  L+   +N  +   + +
+     +   +  F+  G+O  + +
+  +  +++++++++++++++++ +
+                       +
+++++++++++++++++++++++++
#end