#domain
hospital
#levelname
RoboMatic
#colors
blue: 0,1,2,A
#initial
+++++++++++++
+0   1      +
+A      +++ +
+         +++
+    2  +   +
+       + + +
+++++++++++++
#goal
+++++++++++++
+           +
+       +++ +
+         +++
+       +   +
+       +2+A+
+++++++++++++
#end
