#domain
hospital
#levelname
TheMAtrix
#colors
blue: 0, A, B, C, D
red: 1, E, F, G, H
green: 2, I
#initial
++++++++++++++++++++
+ 1     +         I+
+ + + + ++++++++++ +
+ E F G + +H++++   +
+ +++++          2 +
+ A B C +++++D++   +
+ + + + +  +++++ +++
+ 0     +          +
++++++++++++++++++++
#goal
++++++++++++++++++++
+D      +A         +
+ + + + ++++++++++ +
+       +2+ ++++G  +
+I+++++            +
+       +++++ ++   +
+ + + + +EF+++++ +++
+H      +        BC+
++++++++++++++++++++
#end