#domain
hospital
#levelname
VIA
#colors
blue: 0, A
green: 1, B
lightblue: 2, C
cyan: 3, D
#initial
++++++++++++++++++
+                +
+     ++++++     +
+    0      1    +
++++    BB    ++++
++++    BB    ++++
+    AA    CC    +
+    AA    CC    +
++++    DD    ++++
++++    DD    ++++
+    3      2    +
+     ++++++     +
+                +
++++++++++++++++++
#goal
++++++++++++++++++
+                +
+CC   ++++++   DD+
+CC            DD+
++++          ++++
++++          ++++
+                +
+                +
++++          ++++
++++          ++++
+BB            AA+
+BB   ++++++   AA+
+                +
++++++++++++++++++
#end
